Usuario: Miguel ID 1334

Fecha: 2022-09-12T12:02:28.073053300

INFORMACION SOBRE CAPITALES

Capital de A Coruña: A Coruña
Capital de Alacant: Alacant
Capital de Albacete: Albacete
Capital de Almería: Almería
Capital de Araba: Araba
Capital de Asturias: Asturias
Capital de Badajoz: Badajoz
Capital de Barcelona: Barcelona
Capital de Bizkaia: Bizkaia
Capital de Burgos: Burgos
Capital de Cantabria: Cantabria
Capital de Castelló: Castelló
Capital de Ceuta: Ceuta
Capital de Ciudad Real: Ciudad Real
Capital de Cuenca: Cuenca
Capital de Cáceres: Cáceres
Capital de Cádiz: Cádiz
Capital de Córdoba: Córdoba
Capital de Gipuzcoa: Gipuzcoa
Capital de Girona: Girona
Capital de Granada: Granada
Capital de Guadalajara: Guadalajara
Capital de Huelva: Huelva
Capital de Huesca: Huesca
Capital de Illes Balears: Illes Balears
Capital de Jaén: Jaén
Capital de La Rioja: La Rioja
Capital de Las Palmas: Las Palmas
Capital de León: León
Capital de Lleida: Lleida
Capital de Lugo: Lugo
Capital de Madrid: Madrid
Capital de Melilla: Melilla
Capital de Murcia: Murcia
Capital de Málaga: Málaga
Capital de Navarra: Navarra
Capital de Ourense: Ourense
Capital de Palencia: Palencia
Capital de Pontevedra: Pontevedra
Capital de Salamanca: Salamanca
Capital de Santa Cruz de Tenerife: Santa Cruz de Tenerife
Capital de Segovia: Segovia
Capital de Sevilla: Sevilla
Capital de Soria: Soria
Capital de Tarragona: Tarragona
Capital de Teruel: Teruel
Capital de Toledo: Toledo
Capital de Valladolid: Valladolid
Capital de València: València
Capital de Zamora: Zamora
Capital de Zaragoza: Zaragoza
Capital de Ávila: Ávila
